@@@@@@@@@@@@@@@@@@@@@@@@@@@@@@@@@@@
@0        1 1 1   1               @
@@@@@@@@@@@@@@@@@@@@@@@@@@@@@@@@  @
@    1                         @  @
@ @@ @        1    @              @
@ @     @@   @@       @   @       @
@ @          @@@            1  @  @
@ @           @        @@  @@@    @
@ @                 @@            @
@G@       @@      1               @
@@@@@  @@@@@   @@@@               @
