@@@@@@@@@@@@@@@@@@@@@@
@                    @
@                    @
@        @           @
@                    @
@           @        @
@ 1                  @
@                 @  @
@        0           @
@@@@@@@@@@@@@@@@@@@@@@
