@@@@@@@@@@@@@@@@@@@@@@
@                    @
@                    @
@        @           @
@                    @
@           @        @
@                    @
@                 @  @
@                    @
@@@@@@@@@@@@@@@@@@@@@@
