@@@@@@@@@@@@@@@@@@@@@@
@                    @
@                    @
@        @           @
@    0               @
@           @  @     @
@ 1                  @
@                 @  @
@                    @
@@@@@@@@@@@@  @@@@@@@@
